NO ./MAPS/TEST/north.png
SO ./MAPS/TEST/south.png
WE ./MAPS/TEST/west.png
EA ./MAPS/TEST/east.png

F 220,100,0
C 225,30,0

        11111111111111111111111111
        10000000001100000000000111
        10110000011100000000000111
        10010000000000000000000111
1111111110110000011100000000000111
1000000000000000000000000000000111
1000000000000000000000000000000111
100000000000N000000000000000000111
1000000000000000000000000000000111
1000000000000000000000000000000111
1000000000000000000000000000000111
1000000000000000000000000000000111
1000000000000000000000000000000111
1111111111111111111111111111111111