NO ./MAPS/TEST/north.png
SO ./MAPS/TEST/south.png
WE ./MAPS/TEST/west.png
EA ./MAPS/TEST/east.png

F 220,100,0
C 225,30,0

1111111111111111111111111111111111
1000100000000000000000000000000001
1000000010000100000000000000000001
1000000100000010000000000000000001
1000000000N00000000000000000000001
1000000000000000000000000000000001
1000000000000000000000000000000001
1000000000000000000000000000000001
1000000000000000000000000000000001
1000000000000000000000000000000001
1000000000000000000000000000000001
1000000000000000000000000000000001
1000000000000000000000000000000001
1000000000000000000000000000000001
1000000000000000000000000000000001
1000010000000010000000000000000001
1111111111111111111111111111111111