NO ./p ath_to_   the_north_texture



F 0, 0, 0,
C 255,255,255


SO ./path_to_    the_south_texture
WE ./path_to_   the_west_texture



EA ./path_to_   the_east_texture



        1111111111111111111111111
        1000000000110000000000001
        1011000001110000010000001
        1001000000000000100000001
111111111101100000111000000000001
100000000011000001110111111111111
11110111111111011100000010001
11110111111111011101010000001
11000000110101011100000010001
10000000000000001100000010001
10000000000000001101010010001
11000001110101011111011110N0111
11110111 1110101 101111010001
11111111 1111111 111111111111